NO ./textures/bricks.xpm
SO ./textures/metro.xpm
WE ./textures/zizou.xpm
EA ./textures/wood.xpm
F 220,100,0
C 225,30,0



     111111
1111110000011
11110000100001
110000111100001
110000111100001111
100001110111000001
10000111110N000111
110001111000111
1110001100001
111100000001
11011100011
1111111111